1231e231e2
231e231e23
31e231e23e
1e231e23e1
e231e23e12