M0M0M0M0
M000M0MM
M000M0MM
M000M00M
0MM0000M