1111111111
1222222221
1233333321
1222222221
1111111111