M0W0M0U0
M0M0U0MM
S000M0MM
M000M00M
0MU0U00W