1111311111
1222322221
3333333333
1222322221
1111311111